XXXXXX2222XXXXXXXX
X         6    H0X
X         6      X
X         6      X
5         6      X
5         6      X
5    XX   XH1    X
5     X XX       X
5    SXX         X
5     X XX H2    X
5    XX   X      X
5         7      X
5         7      X
5     B2  7      X
5         7      X
X         7    H0X
X         7      X
XXXXXX1111XXXXXXXX
